NNYYYYYYYYYNN
NYNNNNNNNNNYN
NYNYYYYYYYNYN
NYNNNNNNNNNYN
NNYYYYYYYYYNN